   1    2    6    7   15   16   28   29   45   46   66   67   91   92  120  121  153  154  190  191  231  232  276  277  325  326  378  379  435  436  496  497  561  562  630  631  703  704  780  781 
   3    5    8   14   17   27   30   44   47   65   68   90   93  119  122  152  155  189  192  230  233  275  278  324  327  377  380  434  437  495  498  560  563  629  632  702  705  779  782    0 
   4    9   13   18   26   31   43   48   64   69   89   94  118  123  151  156  188  193  229  234  274  279  323  328  376  381  433  438  494  499  559  564  628  633  701  706  778  783    0    0 
  10   12   19   25   32   42   49   63   70   88   95  117  124  150  157  187  194  228  235  273  280  322  329  375  382  432  439  493  500  558  565  627  634  700  707  777  784    0    0    0 
  11   20   24   33   41   50   62   71   87   96  116  125  149  158  186  195  227  236  272  281  321  330  374  383  431  440  492  501  557  566  626  635  699  708  776  785    0    0    0    0 
  21   23   34   40   51   61   72   86   97  115  126  148  159  185  196  226  237  271  282  320  331  373  384  430  441  491  502  556  567  625  636  698  709  775  786    0    0    0    0    0 
  22   35   39   52   60   73   85   98  114  127  147  160  184  197  225  238  270  283  319  332  372  385  429  442  490  503  555  568  624  637  697  710  774  787    0    0    0    0    0    0 
  36   38   53   59   74   84   99  113  128  146  161  183  198  224  239  269  284  318  333  371  386  428  443  489  504  554  569  623  638  696  711  773  788    0    0    0    0    0    0    0 
  37   54   58   75   83  100  112  129  145  162  182  199  223  240  268  285  317  334  370  387  427  444  488  505  553  570  622  639  695  712  772  789    0    0    0    0    0    0    0    0 
  55   57   76   82  101  111  130  144  163  181  200  222  241  267  286  316  335  369  388  426  445  487  506  552  571  621  640  694  713  771  790    0    0    0    0    0    0    0    0    0 
  56   77   81  102  110  131  143  164  180  201  221  242  266  287  315  336  368  389  425  446  486  507  551  572  620  641  693  714  770  791    0    0    0    0    0    0    0    0    0    0 
  78   80  103  109  132  142  165  179  202  220  243  265  288  314  337  367  390  424  447  485  508  550  573  619  642  692  715  769  792    0    0    0    0    0    0    0    0    0    0    0 
  79  104  108  133  141  166  178  203  219  244  264  289  313  338  366  391  423  448  484  509  549  574  618  643  691  716  768  793    0    0    0    0    0    0    0    0    0    0    0    0 
 105  107  134  140  167  177  204  218  245  263  290  312  339  365  392  422  449  483  510  548  575  617  644  690  717  767  794    0    0    0    0    0    0    0    0    0    0    0    0    0 
 106  135  139  168  176  205  217  246  262  291  311  340  364  393  421  450  482  511  547  576  616  645  689  718  766  795    0    0    0    0    0    0    0    0    0    0    0    0    0    0 
 136  138  169  175  206  216  247  261  292  310  341  363  394  420  451  481  512  546  577  615  646  688  719  765  796    0    0    0    0    0    0    0    0    0    0    0    0    0    0    0 
 137  170  174  207  215  248  260  293  309  342  362  395  419  452  480  513  545  578  614  647  687  720  764  797    0    0    0    0    0    0    0    0    0    0    0    0    0    0    0    0 
 171  173  208  214  249  259  294  308  343  361  396  418  453  479  514  544  579  613  648  686  721  763  798    0    0    0    0    0    0    0    0    0    0    0    0    0    0    0    0    0 
 172  209  213  250  258  295  307  344  360  397  417  454  478  515  543  580  612  649  685  722  762  799    0    0    0    0    0    0    0    0    0    0    0    0    0    0    0    0    0    0 
 210  212  251  257  296  306  345  359  398  416  455  477  516  542  581  611  650  684  723  761  800    0    0    0    0    0    0    0    0    0    0    0    0    0    0    0    0    0    0    0 
 211  252  256  297  305  346  358  399  415  456  476  517  541  582  610  651  683  724  760  801    0    0    0    0    0    0    0    0    0    0    0    0    0    0    0    0    0    0    0    0 
 253  255  298  304  347  357  400  414  457  475  518  540  583  609  652  682  725  759  802    0    0    0    0    0    0    0    0    0    0    0    0    0    0    0    0    0    0    0    0    0 
 254  299  303  348  356  401  413  458  474  519  539  584  608  653  681  726  758  803    0    0    0    0    0    0    0    0    0    0    0    0    0    0    0    0    0    0    0    0    0    0 
 300  302  349  355  402  412  459  473  520  538  585  607  654  680  727  757  804    0    0    0    0    0    0    0    0    0    0    0    0    0    0    0    0    0    0    0    0    0    0    0 
 301  350  354  403  411  460  472  521  537  586  606  655  679  728  756  805    0    0    0    0    0    0    0    0    0    0    0    0    0    0    0    0    0    0    0    0    0    0    0    0 
 351  353  404  410  461  471  522  536  587  605  656  678  729  755  806    0    0    0    0    0    0    0    0    0    0    0    0    0    0    0    0    0    0    0    0    0    0    0    0    0 
 352  405  409  462  470  523  535  588  604  657  677  730  754  807    0    0    0    0    0    0    0    0    0    0    0    0    0    0    0    0    0    0    0    0    0    0    0    0    0    0 
 406  408  463  469  524  534  589  603  658  676  731  753  808    0    0    0    0    0    0    0    0    0    0    0    0    0    0    0    0    0    0    0    0    0    0    0    0    0    0    0 
 407  464  468  525  533  590  602  659  675  732  752  809    0    0    0    0    0    0    0    0    0    0    0    0    0    0    0    0    0    0    0    0    0    0    0    0    0    0    0    0 
 465  467  526  532  591  601  660  674  733  751  810    0    0    0    0    0    0    0    0    0    0    0    0    0    0    0    0    0    0    0    0    0    0    0    0    0    0    0    0    0 
 466  527  531  592  600  661  673  734  750  811    0    0    0    0    0    0    0    0    0    0    0    0    0    0    0    0    0    0    0    0    0    0    0    0    0    0    0    0    0    0 
 528  530  593  599  662  672  735  749  812    0    0    0    0    0    0    0    0    0    0    0    0    0    0    0    0    0    0    0    0    0    0    0    0    0    0    0    0    0    0    0 
 529  594  598  663  671  736  748  813    0    0    0    0    0    0    0    0    0    0    0    0    0    0    0    0    0    0    0    0    0    0    0    0    0    0    0    0    0    0    0    0 
 595  597  664  670  737  747  814    0    0    0    0    0    0    0    0    0    0    0    0    0    0    0    0    0    0    0    0    0    0    0    0    0    0    0    0    0    0    0    0    0 
 596  665  669  738  746  815    0    0    0    0    0    0    0    0    0    0    0    0    0    0    0    0    0    0    0    0    0    0    0    0    0    0    0    0    0    0    0    0    0    0 
 666  668  739  745  816    0    0    0    0    0    0    0    0    0    0    0    0    0    0    0    0    0    0    0    0    0    0    0    0    0    0    0    0    0    0    0    0    0    0    0 
 667  740  744  817    0    0    0    0    0    0    0    0    0    0    0    0    0    0    0    0    0    0    0    0    0    0    0    0    0    0    0    0    0    0    0    0    0    0    0    0 
 741  743  818    0    0    0    0    0    0    0    0    0    0    0    0    0    0    0    0    0    0    0    0    0    0    0    0    0    0    0    0    0    0    0    0    0    0    0    0    0 
 742  819    0    0    0    0    0    0    0    0    0    0    0    0    0    0    0    0    0    0    0    0    0    0    0    0    0    0    0    0    0    0    0    0    0    0    0    0    0    0 
 820    0    0    0    0    0    0    0    0    0    0    0    0    0    0    0    0    0    0    0    0    0    0    0    0    0    0    0    0    0    0    0    0    0    0    0    0    0    0    0 
